#################
#               #
#  #######  #####
#  #     #  #   #
####  #  ####   #
#  #######  #####
#               #
#################
